############################################
#A#           # #                        B#
# # ######### # ####### # ################ #
# # #       # #         #                  #
# # # ##### # ######### ################### #
# # #   #   #                            # #
# ##### # ######################### #### # #
#     # #                            #   # #
##### # ####################### ###### # # #
#     #                              # # # #
# ################################ # # # # #
#     #                            # # # # #
# ##### ######################### # # # # #
# #                               # # # # #
# # ############################# # # # # #
# #                            ## # # # # #
# # ##########################   # # # # #
# #                           ### # # # # #
# ###########################   # # # # # #
#                          ####  # # # # #
# ###########################   # # # # #
#                         ##### # # # # #
# ###########################   # # # # #
#                         ##### # # # # #
# ################# #########   # # # # #
# #                           # # # # # #
# #                           # # # # # #
# #                           # # # # # #
# #                           # # # # # #
# ############################# # # # # #
############################################
